iqsur-–lirner[N→N][N][Loc][3SgPoss][SgPosd]	iqsulirnerani
tallirpig-–lirner[N→N][N][Ter][3SgPoss][SgPosd]	tallirpilirneranun
kelu[Positional]-–lirner[N→N][N][Loc][3SgPoss][SgPosd]	kelulirnerani
kii[Quant_Qual][S_1Sg]	kiima
kii[Quant_Qual][S_1Pl]	kiimta
kii[Quant_Qual][P_1Pl]	kiimta
kii[Quant_Qual][S_2Sg]	kiivet
kii[Quant_Qual][S_2Pl]	kiivci
kii[Quant_Qual][S_4Sg]	kiimi
kii[Quant_Qual][S_4Pl]	kiimeng
kii[Quant_Qual][P_3Sg]	kiingan
kii[Quant_Qual][P_3Pl]	kiingita
kii[Quant_Qual][P_3Sg]	kiingan
kii-–rrar*[N→N][Quant_Qual][S_4Sg]	kiirrarmi
kii-–rrar*[N→N][Quant_Qual][P_3Sg]	kiirraan
tamar[Quant_Qual][S_2Pl]	tamarpeci
tamar[Quant_Qual][S_2Du]	tamarpetek
tamar[Quant_Qual][S_4Pl]	tamarmeng
tamar[Quant_Qual][P_1Pl]	tamamta
tamalkur[Quant_Qual][P_3Pl]	tamalkuita
tamalkur[Quant_Qual][P_3Sg]	tamalkuan
allakar[Quant_Qual][S_4Pl]	allakarmeng
allakar[Quant_Qual][P_3Pl]	allakaita
kii[Quant_Qual][4Sg]-ete[N→V][V][Intr][Ind][S_3Sg]	kiimetuq
kii[Quant_Qual][4Sg]-ete[N→V]-–llru[V→V][V][Intr][Ind][S_1Sg]	kiimetellruunga
kii[Quant_Qual][4Sg]-ete[N→V]-@~+yuumiite[V→V]-–lar[V→V][V][Intr][Ind][S_3Pl]	kiimecuumiitelartut
kii[Quant_Qual][4Sg]-ete[N→V][V][Intr][Ind][S_2Sg]=qaa[Encl]	kiimetuten-qaa
ikir-+te[V→V][V][Intr][Ind][S_3Sg]	ikirtuq
ikir-@–ngqa[V→V][V][Intr][Ind][S_3Sg]	ikingqauq
inar-+te[V→V][V][Intr][Ind][S_3Sg]	inartuq
inar-@–ngqa[V→V][V][Intr][Ind][S_3Sg]	inangqauq
kamilar-+te[V→V][V][Intr][Ind][S_3Sg]	kamilartuq
kamilar-@–ngqa[V→V][V][Intr][Ind][S_3Sg]	kamilangqauq
kiipir-+te[V→V][V][Intr][Ind][S_3Sg]	kiipirtuq
kiipir-@–ngqa[V→V][V][Intr][Ind][S_3Sg]	kiipingqauq
matar-+te[V→V][V][Intr][Ind][S_3Sg]	matartuq
matar-@–ngqa[V→V][V][Intr][Ind][S_3Sg]	matangqauq
mumig-+te[V→V][V][Intr][Ind][S_3Sg]	mumigtuq
mumig-@–ngqa[V→V][V][Intr][Ind][S_3Sg]	mumingqauq
nanger-+te[V→V][V][Intr][Ind][S_3Sg]	nangertuq
nanger-@–ngqa[V→V][V][Intr][Ind][S_3Sg]	nangengqauq
palur-+te[V→V][V][Intr][Ind][S_3Sg]	palurtuq
palur-@–ngqa[V→V][V][Intr][Ind][S_3Sg]	palungqauq
quyur-+te[V→V][V][Intr][Ind][S_3Pl]	quyurtut
quyur-@–ngqa[V→V][V][Intr][Ind][S_3Pl]	quyungqaut
inar[Quant_Qual][S_1Sg]	inarma
inar-@–ngqa[V→V][V][Intr][Sbrd][S_1Sg]	inangqalua
kamilar[Quant_Qual][S_4Pl]	kamilarmeng
kamilar-@–ngqa[V→V][V][Intr][Sbrd][S_4Pl]	kamilangqaluteng
matar[Quant_Qual][P_3Sg]	mataan
matar-@–ngqa[V→V]-@+cete/.vkar[V→V][V][Trns][Sbrd][P_3Sg]	matangqavkarluku
aqum-@–ngqa[V→V][Quant_Qual][S_1Sg]	aqumgarma
inar-@–ngqa[V→V][Quant_Qual][S_1Sg]	inangqarma
aklur-+(r)tuuma(r)[N→V][Quant_Qual][S_4Sg]	aklurtuumarmi
aklur-+(r)tuuma(r)[N→V][V][Intr][Sbrd][S_4Sg]	aklurtuumaluni
aipar-+(r)tuuma(r)[N→V][Quant_Qual][P_3Sg]	aipartuumaan
qimugte-+(r)tuuma(r)[N→V][V][Intr][Sbrd][S_4Sg]	qimugtertuumaluni
qimugte-+(r)tuuma(r)[N→V][Quant_Qual][S_4Pl]	qimugtertuumarmeng
takar-@~+yug[V→V][V][Intr][Ind][S_3Sg]	takaryugtuq
takar-@–ke[V→V][V][Trns][Ind][A_3Sg][P_3Sg]	takaqaa
takar-@~+narqe[V→V][V][Intr][Ind][S_3Sg]	takarnarquq
takar-@~+naite[V→V][V][Intr][Ind][S_3Sg]	takarnaituq
takar-+tar[V→V][V][Intr][Ind][S_3Sg]	takartartuq
alinge-@~+narqe[V→V][V][Intr][Ind][S_3Sg]	alingnarquq
alinge-@~+naite[V→V][V][Intr][Ind][S_3Sg]	alingnaituq
tuqu-@~+narqe[V→V][V][Intr][Ind][S_3Sg]	tuqunarquq
tuqu-@~+naite[V→V][V][Intr][Ind][S_3Sg]	tuqunaituq
anglanarqe[V][Intr][Ind][S_3Sg]	anglanarquq
anglanaite[V][Intr][Ind][S_3Sg]	anglanaituq
cumaci-@~+yug[V→V][V][Intr][Ind][S_3Sg]	cumaciyugtuq
cumaci-@–ke[V→V][V][Trns][Ind][A_3Sg][P_3Sg]	cumacikaa
cumaci-@~+narqe[V→V][V][Intr][Ind][S_3Sg]	cumacinarquq
cumaci-@~+naite[V→V][V][Intr][Ind][S_3Sg]	cumacinaituq
cumaci-+tar[V→V][V][Intr][Ind][S_3Sg]	cumacitartuq
caperr-@~+yug[V→V][V][Intr][Ind][S_3Sg]	caperrsugtuq
caperr-@–ke[V→V][V][Trns][Ind][A_3Sg][P_3Sg]	caperqaa
caperr-@~+narqe[V→V][V][Intr][Ind][S_3Sg]	caperrnarquq
caperr-@~+naite[V→V][V][Intr][Ind][S_3Sg]	caperrnaituq
cikna[V][Intr][Ind][S_3Sg]	ciknauq
cikna-@–ke[V→V][V][Trns][Ind][A_3Sg][P_3Sg]	ciknakaa
cikna-@~+narqe[V→V][V][Intr][Ind][S_3Sg]	ciknanarquq
tunrir[V][Intr][Ind][S_3Sg]	tunrirtuq
tunrir-@–ke[V→V][V][Trns][Ind][A_3Sg][P_3Sg]	tunrikaa
tunʼernarqe[V][Intr][Ind][S_3Sg]	tunʼernarquq
alinge[V][Intr][Ind][S_3Sg]	alinguq
alike[V][Trns][Ind][A_3Sg][P_3Sg]	alikaa
alinge-@~+narqe[V→V][V][Intr][Ind][S_3Sg]	alingnarquq
alinge-+tar[V→V][V][Intr][Ind][S_3Sg]	alingtartuq
iluteqe[V→N][N][Rel][Unpd][Sg]	iluteqem
qavar[V→N][N][Rel][Unpd][Sg]	qavam
kasnguyug[V→N][N][Rel][Unpd][Sg]	kasnguyuum
kaig[V→N][N][Rel][Unpd][Sg]	kaigem
ugaani[N][Loc][3SgPoss][SgPosd]	ugaani
cukaite[V→N][N][Rel][Unpd][Sg]	cukaitem
keneke[V→N][N][Rel][Unpd][Sg]	kenkem
ui-–nge[N→V]-@~+yuumiite[V→V][V→N][N][Rel][Unpd][Sg]	uingyuumiitem
qilug-@~–ke[V→N][N][Abs][3SgPoss][SgPosd]	qilukii
qilug-@~–kengar[V→N][N][Abs][3SgPoss][SgPosd]	qilukengaa
nere-@~–ke[V→N][N][Abs][3SgPoss][PlPosd]	nerkai
nere-@~–kengar[V→N][N][Abs][3SgPoss][PlPosd]	nerkengai
kipute-@~–ke[V→N][N][Abs][2SgPoss][SgPosd]	kipusken
kipute-@~–kengar[V→N][N][Abs][2SgPoss][SgPosd]	kipuskengan
kipute-@~–kengar[V→N][N][Abs][2SgPoss][SgPosd]	kipukengan
atur-–nrite[V→V]-@~–ke[V→N][N][Abs][1SgPoss][SgPosd]	atunrilkeka
atur-–nrite[V→V]-@~–kengar[V→N][N][Abs][1SgPoss][SgPosd]	atunrilkengaqa
atur-?pag[V→V][V][Intr][Ind][S_3Sg]	aturpagtuq
qaner-?pag[V→V][V][Intr][Ind][S_3Sg]	qanpagtuq
qaner-?pag[V→V][V][Trns][Ind][A_3Sg][P_3Sg]	qanpautaa
nere-?pag[V→V][V][Intr][Ind][S_3Sg]	nerepʼagtuq
pupsug-?pag[V→V][V][Trns][Ind][A_3Sg][P_3Sg]	pupcepʼagaa
pupsug-?pag[V→V][V][Trns][Ind][A_3Sg][P_3Sg]	pupespagaa
pupsug-?pag[V→V][V][Trns][Ind][A_3Sg][P_3Sg]	pupesvagaa
alleg-?pag[V→V][V][Intr][Ind][S_3Sg]	alpagtuq
quser-?pag[V→V][V][Intr][Ind][S_3Sg]	quspagtuq
nengle-?pag[N→V][V][Intr][Ind][S_3Sg]	nengelvagtuq
nengle-?pag[N→V][V][Intr][Ind][S_3Sg]	nengelpagtuq
akerta-?pag[N→V][V][Intr][Ind][S_3Sg]	akervagtuq
kiir-?pag[N→V][V][Intr][Ind][S_3Sg]	kiirpagtuq
kiir-?pag[N→V][V][Intr][Ind][S_3Sg]	kiirvagtuq
anuqe-?pag[N→V][V][Intr][Ind][S_3Sg]	anurvagtuq
anuqe-?pag[N→V][V][Intr][Ind][S_3Sg]	anuqvagtuq
anuqe-?pag[N→V][V][Intr][Ind][S_3Sg]	anuqʼvagtuq
ella-?pag[N→V][V][Intr][Ind][S_3Sg]	ellarvagtuq
elite-@nga[V→V][V][Intr][Ind][S_3Sg]	elisngauq
mitʼe-@nga[V→V][V][Intr][Ind][S_3Sg]	misngauq
kitugte-@nga[V→V][V][Intr][Ind][S_3Sg]	kitugngauq
uterte-@nga[V→V][V][Intr][Ind][S_3Sg]	uterngauq
sagte-@nga[V→V][V][Intr][Ind][S_3Sg]	sagingauq
upte-@nga[V→V][V][Intr][Ind][S_3Sg]	upingauq
nengte-@nga[V→V][V][Intr][Ind][S_3Sg]	nengingauq
ulte-@nga[V→V][V][Intr][Ind][S_3Sg]	ullesngauq
ulte-@nga[V→V][V][Intr][Ind][S_3Sg]	ullingauq
kia[DemAdv]-+var[N→V][V][Intr][Ind][S_3Sg]	kiavartuq
qule[Positional]-+var[N→V][V][Intr][Ind][S_3Sg]	qulvartuq
qule[Positional]-+var[N→V][V][Trns][Ind][A_3Sg][P_3Sg]	qulvaraa
nat-+var[N→V][V][Intr][Intrg][S_2Sg]	natvarcit
kaig-–nrir[V→V][V][Intr][Ind][S_1Sg]	kainrirtua
nere-–nrir[V→V][V][Trns][Ind][A_3Sg][P_3Sg]	nerenriraa
yuu-–nrir[V→V][V][Intr][Ind][S_3Sg]	yuunrirtuq